...............
.gg.g.*.g.*.*..
.ggggg*gg*g***.
..g.g.*.t.g.g..
.******ggg****.
..g.g.g.g.g.g..
.**g**g**gggtg.
..g.g.g.*.g.g..
.ggggtgg*g*g*g.
..g.g.g.*.g.g..
.ggggggg*ggg*g.
..g.g.g.*.g.g..
.g4**ggg**3***.
..m.m.g.c.m.m..
...............